1000000987
.........o
..........
..........
..o.......
..........
..........
..........
..........
..........
..........
